XXXXXXXa.wav	: Battle Cry 1
XXXXXX8.wav	: Battle Cry 2
XXXXXX9.wav	: Battle Cry 3
XXXXXXg_.wav	: Battle Cry 4
XXXXXXh_.wav	: Battle Cry 5
XXXXXXXb.wav	: Becoming Leader
XXXXXXXc.wav	: Tired
XXXXXXXd.wav	: Bored
XXXXXXXe.wav	: Badly Wounded
XXXXXXXf.wav	: Selected 1
XXXXXXXg.wav	: Selected 2
XXXXXXXh.wav	: Selected 3
XXXXXX0.wav	: Selected 4
XXXXXXk_.wav	: Selected 5
XXXXXXl_.wav	: Selected 6
XXXXXXw_.wav	: Rare Selected 1
XXXXXXx_.wav	: Rare Selected 2
XXXXXXXi.wav	: Action Acknowledgement 1
XXXXXXXj.wav	: Action Acknowledgement 2
XXXXXXXk.wav	: Action Acknowledgement 3
XXXXXXs.wav	: Action Acknowledgement 4
XXXXXXt.wav	: Action Acknowledgement 5
XXXXXXu.wav	: Action Acknowledgement 6
XXXXXXv.wav	: Action Acknowledgement 7
XXXXXXXl.wav	: Being Hit
XXXXXXXm.wav	: Dying
XXXXXXXn.wav	: In Forest
XXXXXXXo.wav	: In City
XXXXXXXp.wav	: In Dungeon
XXXXXXXq.wav	: Daytime
XXXXXXXr.wav	: Nighttime
XXXXXXXs.wav	: Rare Selected 1
XXXXXXXt.wav	: Rare Selected 2
XXXXXXXu.wav	: Rare Selected 3
XXXXXXXv.wav	: Rare Selected 4
XXXXXXXw.wav	: Reaction to Party Member Death